{
	"level": {
			"backgroundFilepath": "../Data/Sprites/Menu.png",
			"player1PosIndex": [ 0, 0 ],
			"player2PosIndex": [ 0, 0 ],
		"levelLayout": {
			"gridDimensions": [ 25, 11 ],
			"gridSize": 64,
			"randomizeBreakableWalls": {
				"isRandomized": true,
				"amount": 20
			},
			"layout": [
				"1111111111111111111111111",
				"1000000000000000000000001",
				"1010101010101010101010101",
				"1000000000000000000000001",
				"1010101010101010101010101",
				"1000000000000000000000001",
				"1010101010101010101010101",
				"1000000000000000000000001",
				"1010101010101010101010101",
				"1000000000000000000000001",
				"1111111111111111111111111"
			]
		}
			
		}
}